WWWWWWWWWWWWWWWWWWWWWWWWWWWWWWW
W     W     W       W         W
W   WWW  M  WW   E  W   WWWWWWW
W        W   WW WWWWW      W  W
W   W    W   WW  W         W  W
W   W   WW    WW WWWWWW WWWWW W
W WWW   WW    W       W W     W
W  W    W             W W  WWWW
WW W    W             W W  WWWW
W       W             W W  WWWW
WWWWWWWWWWWWWWWWWWWWWWWWWWWWWWW